+---+---+---+---+---+---+---+---+---+---+---+---+---+---+---+---+
                                    |           |               |
+   +---+---+---+---+---+---+   +   +   +---+---+   +---+   +---+
|   |                           |           |                   |
+   +   +---+---+   +---+   +---+---+   +---+---+---+   +---+---+
|   |           |               |           |                   |
+   +---+---+---+   +---+---+   +---+   +---+---+---+   +---+---+
|                               |                               |
+---+---+---+---+---+   +---+---+---+---+---+---+---+---+---+   +
|                               |                               |
+---+---+---+---+---+---+---+   +   +   +---+---+---+---+---+---+
|                                   |                           |
+   +---+---+---+---+---+---+   +   +---+---+---+---+---+---+   +
|   |                           |   |           |               |
+   +   +---+---+   +---+   +---+   +---+---+   +   +   +   +   +
|   |           |               |                               |
+   +---+---+---+   +---+---+   +---+   +---+   +---+   +---+   +
|           |                       |                           |
+---+   +---+   +---+   +---+   +---+   +   +   +   +   +   +   +
|                               |                               | 
+---+---+   +---+---+   +---+---+---+---+---+---+---+---+---+---+
|                               |   |           |               |
+   +---+---+---+---+---+---+   +   +   +---+---+   +---+   +---+
|   |                                       |                   |
+   +   +---+---+   +---+   +---+---+   +---+---+---+   +---+---+
|   |           |               |           |                   |
+   +---+---+---+   +---+---+   +---+   +---+---+---+   +---+---+
|           |                   |           |                   |
+---+   +---+---+---+   +---+---+---+---+---+---+---+---+---+   +
|                               |                               |
+---+---+---+---+---+---+---+   +---+---+---+---+---+---+---+   +
|                                                               |
+   +---+---+---+---+---+---+   +   +---+---+---+---+---+---+   +
|   |                           |   |           |               |
+   +   +---+---+   +---+   +---+---+---+---+---+---+---+---+   +
|   |           |               |                               |
+---+---+---+---+---+---+---+   +   +---+---+---+---+---+---+   +
|           |                       |                           |
+---+   +---+   +---+   +---+   +---+---+---+---+---+   +---+---+
|                               |                               | 
+---+---+---+---+---+   +---+---+---+---+---+---+---+---+---+---+
|                               |   |           |               |
+   +---+---+---+---+---+---+   +   +   +---+---+   +---+   +---+
|   |                           |                               |
+   +   +---+---+   +---+   +---+---+   +---+---+---+   +---+---+
|   |           |                           |                   |
+   +---+---+---+   +---+---+   +---+   +---+---+---+   +---+---+
|           |                   |                               |
+---+   +---+---+---+   +---+---+---+---+---+---+---+---+---+   +
|                               |                               |
+---+---+---+---+---+---+---+---+   +---+---+---+---+---+---+   +
|                                                               |
+   +---+---+---+---+---+---+   +   +   +   +   +   +   +   +---+
|   |                           |                               |
+   +---+---+---+---+---+---+   +   +---+---+---+---+---+---+   +
|   |           |               |                               |
+   +---+---+---+   +---+---+   +   +---+---+---+---+---+---+   +
|           |                       |                           |
+---+   +---+   +---+   +---+   +---+   +   +   +   +   +   +   +
|                               |                                
+---+---+---+---+---+---+---+---+---+---+---+---+---+---+---+---+
